1111111111111
1P001C000C001
1100111001101
1000C10E01101
1000111C001C1
100C000C00001
1111111111111
